1111111111111111111111111111111
10011111C1111000000000000P11111
10011111C0000000000000000001111
111C0000000000000000011111E0000
1111111111111111111111111111111