1111111111111111111111111111111
1C10P00000001000000000000111E11
1010000000001C00000000000001011
1011000001111111000100000000011
1000000000000000000100000011111
1000111111100000111100000001111
111C1000C00000001C00011111000C1
1111111111111111111111111111111